10
21
##########E##########
# ######## #        #
# ##       ######## #
# ########          S
#          ##########
# ###################
#           #########
# #########         #
# #         ####### #
###################S#
