15
17
#E###############
# ##            #
# ## ########## #
# ## #          #
# ## # # ##&### #
# ## # # #    # #
# #  # # #### # #
# ## # #      # #
# ## # # ###A####
# ## # # #      #
# ## # # # ## # #
# ## # # #  # # #
# ## # ###@## # #
#    #        # #
###############S#
